.......................................
.......................................
.......................................
.......................................
.......................................
..bbbb..b...b..bbb...bbb..b...b.bbbb...
..b...b.b...b.b...b.b...b.bb.bb.b......
..bbbb...b.b..b.....bbbbb.b.b.b.bbb....
..b.......b...b..bb.b...b.b...b.b......
..b.......b...b...b.b...b.b...b.b......
..b.......b....bbb..b...b.b...b.bbbb...
.......................................
........wwwww.............wwwww........
.......................................
..bbbb..b...b..bbb...bbb..b...b.bbbb...
..b...b.b...b.b...b.b...b.bb.bb.b......
..bbbb...b.b..b.....bbbbb.b.b.b.bbb....
..b.......b...b..bb.b...b.b...b.b......
..b.......b...b...b.b...b.b...b.b......
..b.......b....bbb..b...b.b...b.bbbb...
.......................................
.......................................
.......................................
.................bbbb..................
.................b..b..................
.................b..b..................